0000030000000000000000000
0000333000000000000000000
0000030000111100000000000
0000000111979710001000000
0000001999919791019100000
0000001919971797199100000
0000001999971797999100000
0000000199919797199100000
0000000011179791019100000
0000000000011110001000000