0000000000000000000000000
0000000000000000000770000
0000100000000000007777700
0000111000000000077777770
0000011110000011177000000
0000011111111111177111100
0000001111111111177111100
0000000111111111177000000
0000000001111100077000000
0000000000000000007000000