0000000000000000000000000
0000000111111111110000000
0000001733337333331000000
0000017333337333337100000
0000017333377733337100000
0000017777771777777100000
0000017333377733337100000
0000017333333333337100000
0000017711111111137100000
0000011110000000111100000