0000000010000000100000000
0000000110000000110000000
0000000001111111000000000
0000000001001001000000000
0000000001001001000000000
0000000001110111000000000
0000000000111110000000000
0000000001011101000000000
0000000110000000110000000
0000000010000000100000000