0000000000000100000000000
0000001000001910000010000
0000019100001931000191000
0000013910001991001931000
0000001391001931019910000
0000001991019310019310000
0000001391019910019910000
0000013991019310019310000
0000001399191931199910000
0000000139911991999310000