0000000000000000000000000
0000011111100000111111000
0000177777710001777777100
0000179797771017779797100
0000199799771017799799100
0001799799771017799799710
0001777777111011177777710
0001717177100000177171710
0001717171000000017171710
0001111111000000011111110