0000000001001000000000000
0000000077717000000000000
0000000077717700000000000
0000000001017700000000000
0000000077717770000000000
0000007777717770000000000
0000007777711000000000000
0000000011111111000000000
0000000011111110000000000
0000000011111100000000000