0000000110001110000100000
0000001510015551001510000
0000015510155551015510000
0000015510155551015100000
0000015551115555155100000
0000001155101155151000000
0000000015511015510000000
0000000001551115510000000
0000000000155551510000000
0000000000011111100000000