0000000077000007700000000
0000077711700071177700000
0000071111177711111700000
0000071111111111111700000
0000011111000001111100000
7700111111010101111110077
1171111111000001111111711
1111111111101011111111111
1111111111111111111111111
0111119999999999999111110